00.rlg327
                                                                                
                            ###############                                     
                         ####             #                                     
                         #                #####                                 
     ....               ##                    ##                                
     ....################                 @<.. #                                
     ....                                 .... #                                
     ....########                         .... #                                
                #                         .... #                                
                <...                      .... #####......                      
                ....                      ....      ......                      
                ....######....            .>..      ......                      
                ....      ....####....... ....        #                         
                          ....    .......#....        #                         
                                  .......  #          #                         
                                           #    .......                         
                                           ##   .......                         
                                            #   .......                         
                                            ####.....>.                         
                                                                                
                                                                                

01.rlg327
                                                                                
                            ###############                                     
                         ####             #                                     
                         #                #####                                 
     ....               ##                    ##                                
     ....################                 @<.. #                                
     ....                                 .... #                                
     ....########                         .... #                                
                #                         .... #                                
                <...                      .... #####......                      
                ....                      ....      ......                      
                ....######....            .>..      ......                      
                ....      ....####....... ....        #                         
                          ....    .......#....        #                         
                                  .......  #          #                         
                                           #    .......                         
                                           ##   .......                         
                                            #   .......                         
                                            ####.....>.                         
                                                                                
                                                                                

02.rlg327
                                                                                
                                                                                
                                                                                
                                                    @...                        
            ....#<###############.....              ....                        
            ....                 .....              ....                        
            ....                 .....                 #                        
            ....                     #                 #                        
            ....                     #                 #                        
            ....                     ##############>##################......    
            ....                #######                #              ......    
            #                   #    ##                #              ......    
         ......##################     ####             #              ......    
         ......                          #....         #              ......    
         ......                           ....     .....              ......    
         ......                           ....#####.....              ......    
         ......                                    .....                        
                                                                                
                                                                                
                                                                                
                                                                                

03.rlg327
                                                                                
                                   ###########################                  
                                  ##                         #                  
            .....                 #                          ......             
            .....            ......                          ......             
            .....            ......                          ......             
            .....            ......                               #             
            #                ......                             ........        
           @........         #                                  ........        
   .<.....#......... ....    #                                  ........        
   ....... .........#....#############################    ....##........        
   ....... ......... ....    #                       ###  ....         #        
   ....... ......... ....    ####.....                 ## ....    .........     
           ......... ....        .....                  ##        .........     
           .........#....        .....                   #        .........     
           ......... ....                                ####>####     #        
           .........                                             #######        
           .........                                                            
                                                                                
                                                                                
                                                                                

04.rlg327
                                                                                
   ######################################                                       
   #                                    #                                       
  @...<                                 ##                                      
  .....                           ...... #                                      
  .....                           ...... ##                           .....     
  .....                   ########......########                      .....     
      #                 ###                    ################....###.....     
      #                ##                                      ....             
      #####>#        ###                                      #....             
            .....#####                                        #                 
            .....                                             #                 
            .....                                             #                 
            .....                                             #                 
            .....                                      ........                 
            .....                                      ........                 
            .....                                      ........                 
                                                                                
                                                                                
                                                                                
                                                                                

05.rlg327
                                                                                
     .......                                                                    
     .......                                                 .....              
     .......###                                              .....              
              #       ........      @....... ############### ...>.   ....       
              #       ........      ........ #             # .....   ....       
              #       ........######........##..<...       ##.....   ....       
              #       ........          #     ......         .....###....       
              #     ##........          #     ......         .....              
              ##    #       #           #     ......###<#####.....              
               ####........ #           #                    .....              
                   ........ #           #                                       
                   ........ #     #######                                       
                   ........ #     #                                             
  ..............###........##     #                                             
  ..............    #             #                                             
  ..............    #            ##                                             
                    #          ###                                              
                    #         ##                                                
                    ###########                                                 
                                                                                

06.rlg327
                                                                                
                                                                                
                                                                  ..........    
                                                                  ..........    
                                                                  ..........    
                                                      ....             #        
                                                      ....             #        
       ......                                         ....             #        
       ......                                        #..<.             #        
       ......#####                           ........#                 #        
                 #                           ........                  #        
                 ########@....<              ........                  #        
                         ......              ........                  #        
                         ......##############..>.....############      #        
                         ......                          #      #      #        
                         ......                          #      #      #        
                         ......                          #########.....#        
                         ......                                   .....         
                                                                  .....         
                                                                                
                                                                                

07.rlg327
                                                                                
                    ....                                     ......             
                    ....                                     ......             
                    ....                                     ......##           
                    ....                                     ...... #           
                    ....    ####<###                         <..... #           
                       #    #      ##                        ...... #           
                      @......       #                        ...... #           
  .....               .......       #########################...... #           
  .....               .......         #                     #       #           
  .....               .......         #                     #       #           
  .....               .......         #                    .......  #           
  .....#              .......        ##                    .......  #           
       #####....######.......        #                     ....... ##           
            .... #                ....                            ##            
            .... #################....                           ##             
            ....                  ....##                         #              
            ....                       ###>                    ###              
                                          #                    #                
                                          ######################                
                                                                                

08.rlg327
                                                                                
                                                                                
                                                                                
                     ....                                                       
                     ....                                                       
                    #....######                                   ......        
                    #         ##                                  ......        
                    #          #         .........                ......        
 .....             ##          ......... .........      ##########......        
 .....            ##           ......... ..>......      #           #           
 .....            #            ......... .........      #         ###           
 .....            #            .........#....<....      #     #####             
 .....#########....            ..<...... ......... @.....     #                 
 .....         ....                      ......... ......    ##                 
 .....         ....                      .........#......#####                  
 .....         ....                       #                                     
 .....#########....########################                                     
 .....         ....                                                             
               ....                                                             
                                                                                
                                                                                

09.rlg327
                                                                                
                                                                                
                                                      ....                      
                                                      ....                      
      @...                                            ....                      
      ...<#....###########.....                       ....                      
      .... ....        ## .....                       ....                      
      .... ....         # .....##############         ....                      
           ....         ##        #################   ....###                   
           ....          ##########         #     ### ....  #                   
           ....                             ..<.    # ....  ###                 
           ....                             ....    ###       #                 
           ....                             ....      ###     #                 
           ....                             ....      < ##    #                 
                                               ####..... ##   #                 
                                                   .....  ####......            
                                                   .....      ......            
                                                              ..>...            
                                                              ......            
                                                                                
                                                                                

adventure.rlg327
                                                                                
                                                                                
                                                       @                        
                                                       .                        
                         ###                     ...   .                        
                       ######  #                .....  .                        
                      # ##### # #               .....  .                        
                     #  ######  #         ..... .....  .                        
                     #   ###     #        ..#..  ...  .                         
                          #      #        .###.   .  .                          
                         ##########       ..#........                           
                          ##     #        ..#..   .                             
                         ####    #         ...    .                             
                        ######  #           .     .                             
                       ######## #                . .                            
                      ##########                .   .                           
                          #                     .   .                           
                          #                     .   .                           
                          ##                    .   .                           
                                                                                
                                                                                

hello.rlg327
                                                                                
                                                                                
                                                                                
  @.   .. ....... ..      ..        ...            ...     ...   ....... ..     
  ..   .. ....... ..      ..       .....          .....   .....  ....... ..     
  ..   .. ..      ..      ..      ... ...##      ..  ...#..  ...#..   .. ..     
  ..   .. ..      ..      ..      ..   .. ##          ..      ..     ..  ..     
  ..   .. ..      ..      ..      ..   ..  ##        ..      ..      ..  ..     
  ....... ......##..      ..      .. ##..   ##      ..      ..      ..   ..     
  ....... ......  ..      ..      ..## ..    ##     ..     ..       ..   ..     
  ..   .. ..      ..      ..    ##..   ..     ##     ..   ..       ..    ..     
  ..   .. ..      ..      ..    # ..   ..      ##     .. ..        ..  ##..     
  ..   .. ..      ..      ..    # ... ...       #..  ...#..       ..   # #      
  ..   .. ....... .......#.......  .....          .....  ....... ...   # ..     
  ..   ..#....... ....... .......   ...            ...    ...... ...#### ..     
                                                                                
                                                                                
                                                                                
                                                                                
                                                                                
                                                                                
welldone.rlg327
                                                                                
                                                          @.      ..            
  #     # #### #    #                                    .  ..  ..  .           
  #     # #    #    #                                   .            .          
  #     # #    #    #                                .    ...    ...    .       
  #     # ###  #    #                               . .  .. ..  .. ..  . .      
  #     # #    #    #                               .    .   .  .   .    .      
   # # #  #    #    #                               .     ...    ...     .      
    # #   #### #### ####                             .                  .       
                                                      .       ..       .        
                                                             ....               
                                                                                
                         ###     ##   #   # ####                                
                         #  #   #  #  ##  # #           ..          ..          
                         #   # #    # # # # #           ..          ..          
                         #   # #    # # # # ###          ..  ....  ..           
                         #   # #    # # # # #             ..........            
                         #  #   #  #  #  ## #              ........             
                         ###     ##   #   # ####                                
                                                                                
                                                                                
